1111111111111
1001000C00C01
1E00011111001
1P000000000C1
1111111111111